000000000000000000000000000000000000000000000
000000000000000000000000000000000000000000000
000100000000000000000000000000000000000000000
000110000000000000000000000000001000000000000
000111111111111111101111111111111100000000000
000000000000000000000000001000000000000000000
000000000000000011111111111000000000000000000
000000000000000000000000000000000000000000000
000000000000000000000000000000000000000000000
000000000000000000000000000000000000000000000
000000000000000000000000000000000000000000000
000000000000000000000000000000000000000000000
000000010000000000000000000100000000000000000
000000011111111111111111101110000000000000000
000000000000000000000000000000000000000000000
000000000000000000000000000000000000000000000
000000000000000000000000000000000000000000000
000000000000000000000000000000000000000000000
000000000000000000000000000000000000000000000
000000000000000000000000000000000000000000000
000000000000000000000000000000000000000000000
000000000000000000000000000000000000000000000
000100000000000000000000000000000000000100000
000111111111111111111111111111111111111100000
000000000000000000000000000000000000000000000
000000000000000000000000000000000000000000000
000000000000000000000000000000000000000000000
000000000000000000000000000000000000000000000
000000000000000000000000000000000000000000000
000000000000000000000000000000000000000000000