000000000000000000000000000000000000000000000
000000004000000000000000000000000000000000000
000100000000000000000000000000000000000000000
000110000000000000000000000000001000000000000
000111111111111111101111111111111100000000000
000000000000000000000000001000000000000000000
000000000000000011111111111000000000000000000
000000000000000000000000000000000000000000000
000000000000011100000000000000000000000000000
000000000000000000000000000000000000000000000
000000000000000000000000000000000000000000000
000000000000000000000000000000000000000000000
000000010000000000000000000100000000000000000
000000011111111111133311101110000000000000000
000000000000000000000000000000000000000000000
000000000000000000000000000000000000000000000
000000000000000000000000000000000000000000000
000000000000000000000000000000000000000000000
000000000000000000000000000000000000000000000
000000000000000000000000000000000000000000000
000000000000000000000000000000000000000000000
000000000000000000000000000000000000000000000
000100000000000000000000000000000000050100000
000111111111111111111111111111111111111100000
000000000000000000000000000000000000000000000
000000000000000000000000000000000000000000000
000000000000000000000000000000000000000000000
222222222222222222222222222222222222222222220
